cvv-cvc-ccv-cvcc-ccvc-cvccv-ccvcv V -> cvv-cvc-ccv-cvcc-ccvc-cvccv-ccvcv  X
cvv-cvc-ccv-cvcc-ccvc-cvccv-ccvcv C -> cvv-cvc-ccv-cvcc-ccvc-cvccv-ccvcv  X
cvv-cvc-ccv-cvcc-ccvc-cvccv-ccvcv $ -> cvv-cvc-ccv-cvcc-ccvc-cvccv-ccvcv  X
Cvv-Cvc-Ccv-Cvcc-Ccvc-Cvccv-Ccvcv V -> cvv-cvc-ccv-cvcc-ccvc-cvccv-ccvcv  X (v)
Cvv-Cvc-Ccv-Cvcc-Ccvc-Cvccv-Ccvcv C -> cVv-cVc-cCv-cVcc-cCvc-cVccv-cCvcv  O c(v) | c(c) | c(v) | c(v) | c(c) | c(v) | c(c)
cVv-cVc-cCv-cVcc-cCvc-cVccv-cCvcv V -> cvV-cvC-ccv-cvCc-ccvc-cvCcv-ccvcv  O cv(c) | cv(v) | cv(c) | cv(c)
cVv-cVc-cCv-cVcc-cCvc-cVccv-cCvcv C -> cvv-cvc-ccV-cvcc-ccVc-cvccv-ccVcv  O cc(v) | cc(v) | cc(v)
cvv-cvc-ccV-cvcc-ccVc-cvccv-ccVcv V -> Cvv-Cvc-Ccv-Cvcc-CcvC-Cvccv-CcvCv  B ccv (c) | ccv (c) | ccv (c) | ccv (c) | ccv (c) | ccv(c) | ccv (c) | ccv (c) | ccv(c)
cvv-cvc-ccV-cvcc-ccVc-cvccv-ccVcv C -> cvv-cvc-ccv-cvcc-ccvc-cvccv-ccvcv  X (ccc)
cvV-cvC-ccv-cvCc-ccvc-cvCcv-ccvcv V -> Cvv-Cvc-Ccv-Cvcc-Ccvc-Cvccv-Ccvcv  L cvv (c) | cvv (c) | cvv (c) | cvv (c) | cvv (c) | cvv (c) | cvv (c)
cvV-cvC-ccv-cvCc-ccvc-cvCcv-ccvcv C -> Cvv-Cvc-Ccv-CvcC-Ccvc-CvcCv-Ccvcv  B cvc (c) | cvc (c) | cvc (c) | cvc (c) | cvc(c) | cvc (c) | cvc (c) | cvc(c) | cvc (c)
Cvv-Cvc-Ccv-Cvcc-CcvC-Cvccv-CcvCv V -> cvv-cvc-ccv-cvcc-ccvc-cvccv-ccvcv  X (ccvv)
Cvv-Cvc-Ccv-Cvcc-CcvC-Cvccv-CcvCv C -> CVv-CVc-CCv-CVcc-CCvc-CVccv-CCvcV  B ccvc (c) | ccv c(v) | ccvc (c) | ccv c(c) | ccvc (c) | ccv c(v) | ccvc (c) | ccv c(v) | ccvc (c) | ccv c(c) | ccvc (c) | ccv c(v) | ccvc (c) | ccv c(c) | ccvc(v)
Cvv-Cvc-Ccv-CvcC-Ccvc-CvcCv-Ccvcv V -> cvv-cvc-ccv-cvcc-ccvc-cvccv-ccvcv  X (cvcv)
Cvv-Cvc-Ccv-CvcC-Ccvc-CvcCv-Ccvcv C -> CVv-CVc-CCv-CVcc-CCvc-CVccV-CCvcv  B cvcc (c) | cvc c(v) | cvcc (c) | cvc c(c) | cvcc (c) | cvc c(v) | cvcc (c) | cvc c(v) | cvcc (c) | cvc c(c) | cvcc (c) | cvc c(v) | cvcc(v) | cvcc (c) | cvc c(c)
CVv-CVc-CCv-CVcc-CCvc-CVccv-CCvcV V -> CvV-CvC-Ccv-CvCc-Ccvc-CvCcv-Ccvcv  B ccvcv (c) | ccv cv(c) | ccvcv (c) | ccvcv (c) | ccv cv(v) | ccvcv (c) | ccv cv(c) | ccvcv (c) | ccvcv (c) | ccv cv(c) | ccvcv (c)
CVv-CVc-CCv-CVcc-CCvc-CVccv-CCvcV C -> cVv-cVc-cCV-cVcc-cCVc-cVccv-cCVcv  O ccvc c(v) | ccvc c(c) | ccv cc(v) | ccvc c(v) | ccvc c(v) | ccvc c(c) | ccv cc(v) | ccvc c(v) | ccvc c(c) | ccv cc(v)
cVv-cVc-cCV-cVcc-cCVc-cVccv-cCVcv V -> CvV-CvC-Ccv-CvCc-CcvC-CvCcv-CcvCv  B ccv ccv (c) | ccvc cv(c) | ccv ccv (c) | ccv ccv (c) | ccvc cv(v) | ccv ccv (c) | ccvc cv(c) | ccv ccv (c) | ccv ccv(c) | ccv ccv (c) | ccvc cv(c) | ccv ccv (c) | ccv ccv(c)
cVv-cVc-cCV-cVcc-cCVc-cVccv-cCVcv C -> cvv-cvc-ccV-cvcc-ccVc-cvccv-ccVcv  L ccvc cc(v) | ccvc cc(v) | ccvc cc(v)
CvV-CvC-Ccv-CvCc-Ccvc-CvCcv-Ccvcv V -> Cvv-Cvc-Ccv-Cvcc-Ccvc-Cvccv-Ccvcv  L ccv cvv (c) | ccv cvv (c) | ccv cvv (c) | ccv cvv (c) | ccv cvv (c) | ccv cvv (c) | ccv cvv (c)
CvV-CvC-Ccv-CvCc-Ccvc-CvCcv-Ccvcv C -> CVv-CVc-CCv-CVcC-CCvc-CVcCv-CCvcv  B ccv cvc (c) | ccvcv c(v) | ccv cvc (c) | ccvcv c(c) | ccv cvc (c) | ccvcv c(v) | ccv cvc (c) | ccvcv c(v) | ccv cvc(c) | ccv cvc (c) | ccvcv c(c) | ccv cvc (c) | ccvcv c(v) | ccv cvc(c) | ccv cvc (c) | ccvcv c(c)
CvV-CvC-Ccv-CvCc-CcvC-CvCcv-CcvCv V -> Cvv-Cvc-Ccv-Cvcc-Ccvc-Cvccv-Ccvcv  L ccvc cvv (c) | ccvc cvv (c) | ccvc cvv (c) | ccvc cvv (c) | ccvc cvv (c) | ccvc cvv (c) | ccvc cvv (c)
CvV-CvC-Ccv-CvCc-CcvC-CvCcv-CcvCv C -> CVv-CVc-CCv-CVcC-CCvc-CVcCv-CCvcV  B <ccvc cvc (c) | ccv ccvc (c)> | ccv ccv c(v) | <ccvc cvc (c) | ccv ccvc (c)> | ccv ccv c(c) | <ccvc cvc (c) | ccv ccvc (c)> | ccv ccv c(v) | <ccvc cvc (c) | ccv ccvc (c)> | ccv ccv c(v) | ccvc cvc(c) | <ccvc cvc (c) | ccv ccvc (c)> | ccv ccv c(c) | <ccvc cvc (c) | ccv ccvc (c)> | ccv ccv c(v) | ccvc cvc(c) | <ccvc cvc (c) | ccv ccvc (c)> | ccv ccv c(c) | ccv ccvc(v)
CVv-CVc-CCv-CVcc-CCvc-CVccV-CCvcv V -> CvV-CvC-Ccv-CvCc-Ccvc-CvCcv-Ccvcv  L cvccv (c) | cvc cv(c) | cvccv (c) | cvccv (c) | cvc cv(v) | cvccv (c) | cvc cv(c) | cvccv (c) | cvccv (c) | cvc cv(c) | cvccv (c)
CVv-CVc-CCv-CVcc-CCvc-CVccV-CCvcv C -> cVv-cVc-cCV-cVcc-cCVc-cVccv-cCVcv  L cvcc c(v) | cvcc c(c) | cvc cc(v) | cvcc c(v) | cvcc c(v) | cvcc c(c) | cvc cc(v) | cvcc c(v) | cvcc c(c) | cvc cc(v)
CVv-CVc-CCv-CVcC-CCvc-CVcCv-CCvcv V -> cvV-cvC-ccv-cvCc-ccvc-cvCcv-ccvcv  L ccvcv cv(c) | ccvcv cv(v) | ccvcv cv(c) | ccvcv cv(c)
CVv-CVc-CCv-CVcC-CCvc-CVcCv-CCvcv C -> CVv-CVc-CCV-CVcc-CCVc-CVccV-CCVcv  B ccv cvcc (c) | ccv cvc c(v) | ccv cvcc (c) | ccv cvc c(c) | ccvcv cc(v) | ccv cvcc (c) | ccv cvc c(v) | ccv cvcc (c) | ccv cvc c(v) | ccv cvcc (c) | ccv cvc c(c) | ccvcv cc(v) | ccv cvcc (c) | ccv cvc c(v) | ccv cvcc(v) | ccv cvcc (c) | ccv cvc c(c) | ccvcv cc(v)
CVv-CVc-CCv-CVcC-CCvc-CVcCv-CCvcV V -> CvV-CvC-Ccv-CvCc-Ccvc-CvCcv-Ccvcv  L ccv ccvcv (c) | ccv ccv cv(c) | ccv ccvcv (c) | ccv ccvcv (c) | ccv ccv cv(v) | ccv ccvcv (c) | ccv ccv cv(c) | ccv ccvcv (c) | ccv ccvcv (c) | ccv ccv cv(c) | ccv ccvcv (c)
CVv-CVc-CCv-CVcC-CCvc-CVcCv-CCvcV C -> CVv-CVc-CCV-CVcc-CCVc-CVccV-CCVcv  L ccvc cvcc (c) | <ccvc cvc c(v) | ccv ccvc c(v)> | ccvc cvcc (c) | <ccvc cvc c(c) | ccv ccvc c(c)> | ccv ccv cc(v) | ccvc cvcc (c) | <ccvc cvc c(v) | ccv ccvc c(v)> | ccvc cvcc (c) | <ccvc cvc c(v) | ccv ccvc c(v)> | ccvc cvcc (c) | <ccvc cvc c(c) | ccv ccvc c(c)> | ccv ccv cc(v) | ccvc cvcc (c) | <ccvc cvc c(v) | ccv ccvc c(v)> | ccvc cvcc(v) | ccvc cvcc (c) | <ccvc cvc c(c) | ccv ccvc c(c)> | ccv ccv cc(v)
CVv-CVc-CCV-CVcc-CCVc-CVccV-CCVcv V -> CvV-CvC-Ccv-CvCc-CcvC-CvCcv-CcvCv  L <ccvcv ccv (c) | ccv cvccv (c)> | ccv cvc cv(c) | <ccvcv ccv (c) | ccv cvccv (c)> | <ccvcv ccv (c) | ccv cvccv (c)> | ccv cvc cv(v) | <ccvcv ccv (c) | ccv cvccv (c)> | ccv cvc cv(c) | <ccvcv ccv (c) | ccv cvccv (c)> | ccvcv ccv(c) | <ccvcv ccv (c) | ccv cvccv (c)> | ccv cvc cv(c) | <ccvcv ccv (c) | ccv cvccv (c)> | ccvcv ccv(c)
CVv-CVc-CCV-CVcc-CCVc-CVccV-CCVcv C -> cVv-cVc-cCV-cVcc-cCVc-cVccv-cCVcv  L ccv cvcc c(v) | ccv cvcc c(c) | ccv cvc cc(v) | ccv cvcc c(v) | ccv cvcc c(v) | ccv cvcc c(c) | ccv cvc cc(v) | ccv cvcc c(v) | ccv cvcc c(c) | ccv cvc cc(v)
